.......#..
..#....#..
..#....#..
..#....#..
..#.......
