...RRRR...
.#......#.
.#.#..#.#.
.#.#..#.#.
.#.#..#.#.
