...PPPP...
.#......#.
.#.#..#.#.
.#......#.
.#..CC..#.
