...PPPP......PPPP...
....................
.#...#...##...#...#.
.#...#...##...#...#.
.#...#...##...#...#.
.#...#...##...#...#.
.#...#...##...#...#.
.#...#...##...#...#.
.#...#...##...#...#.
.#...#...##...#...#.
.#...#...##...#...#.
.#...#...##...#...#.
.#...#...##...#...#.
.#...#...##...#...#.
.#...#...##...#...#.
.#...#...##...#...#.
.#...#...##...#...#.
....................
....................
...CCCC......CCCC...